NO ./textures/NO.xpm
SO ./textures/SO.xpm
WE ./textures/WE.xpm
EA ./textures/EA.xpm

F 75, 78, 82
C 101, 101, 102

        1111111111111111111111111
        1000000000110000000000001
        1011000001110000000000001
        1000100000000000000000001
111111111101 1000011100000000000011
100000000010100001110100111111111
11110111111111011100000010001
11110111111111011101010010001
11000000110101011100000010001
1000000000000001100000000001
100000000000000011010101E001
1100000111010101111101111000111
11110111 1110101 101111010001
11111111 1111111 111111111111
