NO /home/vbarbier/Projet_en_cours/Cub3d/textures/NO
SO /home/vbarbier/Projet_en_cours/Cub3d/textures/SO
WE /home/vbarbier/Projet_en_cours/Cub3d/textures/WE
EA /home/vbarbier/Projet_en_cours/Cub3d/textures/EA

F 220,100,0
C 225,30,0

        1111111111111111111111111
        1000000000110000000000001
        1011000001110000000000001
        1000100000000000000000001
111111111101 1000011100000000000011
100000000010100001110111111111111
11110111111111011100000010001
11110111111111011101010010001
11000000110101011100000010001
1000000000000001100000011001
100000000000000011010101E001
1100000111010101111101111000111
11110111 1110101 101111010001
11111111 1111111 111111111111
